
NO textures/ex.xpm
SO textures/ex.xpm
WE textures/ex.xpm
EA textures/ex.xpm

F 220  , 100   ,   0
C 225,30,0

111111111111111
111101010000101
100000000000001
100000S00000001
100000000000001
111111111111111
