
NO textures/frog.xpm
SO textures/kit.xpm
WE textures/mushroom.xpm
EA textures/water_texture.xpm

F 220  , 100   ,   0
C 225,30,0

111111111111111111111111111111111
100000000000000000000000000000001
100000000000000000000000000000001
1000000000N0000000000000000000001
100000000000000000000000000000001
100000000000000000000000000000001
111111111111111111111111111111111
