NO ./path_to_the_north_texture
SO ./path_to_the_south_texture
WE ./path_to_the_west_texture
EA ./path_to_the_east_texture
F 220,100,0
C 225,30,0
1111111111111111111111111
1000000000110000000000001
1011000001110000001000001
1001000000000000000000001
111111111011000001110000111111111
100000000011000001110100000001
111101111111110111000000100001
111101111111111011101010010001
1100000011010101110000010001
1000000000000001100000010001
1000000000000000110101N010001
110000011101010111110111100111
11110111 1110101 101111010001
11111111 1111111 111111111111