
NO /Users/ptopping/Desktop/our_cub/textures/pivozavr.xpm
SO /Users/ptopping/Desktop/our_cub/textures/water_texture.xpm
WE /Users/ptopping/Desktop/our_cub/textures/pivozavr.xpm
EA /Users/ptopping/Desktop/our_cub/textures/water_texture.xpm

F 220  , 100   ,   0
C 225,30,0


1111111111111111111111111111111
1111111110110000011100000000011
1000000000110000011101111111111
1111011111111101110000001000111
1111011111111101110101001000111
1100000011010101110000001000111
10000000N0000000110000001000111
1000000000000000110101001000111
1100000100010101111101111000111
1111011111111111111101111010001
11111111         11111111111111
11111111         11111111111111
